2 1 1 1 1 1 1 1 1 1 1 1 2
2 3 3 3 3 3 3 3 3 3 3 3 2
2 3 1 4 4 5 1 5 4 4 1 3 2
2 3 3 4 4 5 5 5 4 4 3 3 2
2 2 3 1 4 5 5 5 4 1 3 2 2
2 2 3 3 4 4 5 4 4 3 3 2 2