0 0 0 0 0 0 0 0 0 0 0 0 0 0 0	 
0 0 0 0 4 4 5 3 5 4 4 0 0 0 0 
0 0 2 2 1 1 1 1 1 1 1 2 2 0 0 	 
0 0 3 2 0 4 5 1 5 4 0 2 3 0 0 	 
1 0 1 1 1 4 4 1 4 4 1 1 1 0 1 	 
0 0 0 0 0 0 0 0 0 0 0 0 0 0 0	 
0 0 0 0 0 0 0 0 0 0 0 0 0 0 0 
0 0 0 0 0 0 0 0 0 0 0 0 0 0 0