1 1 1 1 1 1 1 1 1 1 1 1 1 1 1 	 
1 0 0 0 0 0 0 0 0 0 0 0 0 0 1	 	 
1 0 5 4 5 0 0 0 0 0 5 4 5 0 1		 
1 0 2 0 0 1 3 3 3 1 0 0 2 0 1		 
1 0 2 0 0 0 1 0 1 0 0 0 2 0 1	 	 
1 0 5 3 2 0 0 0 0 0 2 3 5 0 1		 
1 0 0 0 0 0 0 0 0 0 0 0 0 0 1		 
1 0 0 1 1 1 0 0 0 1 1 1 0 0 1