0 0 0 0 0 0 0 0 0 0 0 0 0 0 0	 
0 0 0 0 0 0 0 0 0 0 0 0 0 0 0 
0 0 0 0 0 0 0 0 0 0 0 0 0 0 0 	 
0 0 3 1 0 4 5 1 5 4 0 1 3 0 0 	 
0 0 4 1 2 3 4 1 4 3 2 1 4 0 0 	 
0 0 0 0 0 0 0 0 0 0 0 0 0 0 0	 
0 0 0 0 0 0 0 0 0 0 0 0 0 0 0 
0 0 0 0 0 0 0 0 0 0 0 0 0 0 0